6 9
WWWWWW
W0000W
WS00aW
WWWAWW
WW00bW
WW000W
WWWBWW
WW00GW
WWWWWW