18 20
WWWWWWWWWWWWWWWWWW
WS00000000000000WW
WWWWWWWWWWWWWWW0WW
W00000000WW000W0aW
WcWW0WWW0WWWW0W0WW
WWB00W0W00A000000W
WW0WWW0W00W0WWWWWW
WW00000C000000000W
W0WWWWW0WWWWWWWW0W
W00000000000000WbW
WWW0WWWWW0WWWW0WWW
W00000W00WWWWW0WeW
WdWWWWWW00D000000W
WW0000WW00WWWW0WWW
WWWWW00W00WWWW0WWW
WG00EW0000000WWW0W
WWWW0WW0WW0W00000W
W000000000000WWW0W
W00WWWW0WWWWWW000W
WWWWWWWWWWWWWWWWWW